// 01Antonica
arena=lakerathe
befallen=commons
beholder=eastkarana,runnyeye
blackburrow=everfrost,qeytoqrg
cazicthule=feerrott
commons=befallen,ecommons,kithicor
eastkarana=beholder,highpass,northkarana
ecommons=commons,freportw,nektulos,nro
everfrost=blackburrow,halas,permafrost
feerrott=cazicthule,fearplane,innothule,oggok,rathemtn
freporte=freportw,nro,oot
freportn=freportw
freportw=ecommons,freporte,freportn
grobb=innothule
gukbottom=guktop
guktop=gukbottom,innothule
halas=everfrost
highkeep=highpass
highpass=eastkarana,highkeep,kithicor
innothule=feerrott,grobb,guktop,sro
kithicor=commons,highpass,rivervale
lakerathe=arena,rathemtn,southkarana
lavastorm=najena,nektulos,soldunga,soldungb,soltemple
misty=rivervale,runnyeye
najena=lavastorm
nektulos=ecommons,lavastorm,neriaka
neriaka=nektulos,neriakb
neriakb=neriaka,neriakc
neriakc=neriakb
northkarana=eastkarana,qey2hh1,southkarana
nro=ecommons,freporte,oasis
oasis=nro,sro,timorous
oggok=feerrott
oot=butcher,freporte
paw=southkarana
permafrost=everfrost
qcat=qeynos,qeynos2
qey2hh1=northkarana,qeytoqrg
qeynos=erudsxing,qcat,qeynos2
qeynos2=qcat,qeynos,qeytoqrg
qeytoqrg=blackburrow,qey2hh1,qeynos2,qrg
qrg=qeytoqrg
rathemtn=feerrott,lakerathe
rivervale=kithicor,misty
runnyeye=beholder,misty
soldunga=lavastorm,soldungb
soldungb=lavastorm,soldunga
soltemple=lavastorm
southkarana=lakerathe,northkarana,paw
sro=innothule,oasis

// 02Faydwer
akanon=steamfont
butcher=cauldron,gfaydark,kaladima,oot,timorous
cauldron=butcher,kedge,unrest
crushbone=gfaydark
felwithea=felwitheb,gfaydark
felwitheb=felwithea
gfaydark=butcher,crushbone,felwithea,lfaydark
kaladima=butcher,kaladimb
kaladimb=kaladima
kedge=cauldron
lfaydark=gfaydark,mistmoore,steamfont
mistmoore=lfaydark
steamfont=akanon,lfaydark
unrest=cauldron

// 03Odus
erudint=erudnext
erudnext=erudint,erudsxing,toxxulia
erudsxing=erudnext,qeynos
hole=paineel
kerraridge=toxxulia
paineel=hole,toxxulia,warrens
stonebrunt=warrens
toxxulia=erudnext,kerraridge,paineel
warrens=paineel,stonebrunt

// 04The Planes
airplane=freporte
fearplane=feerrott
hateplane=

// 05Kunark
burningwood=chardok,dreadlands,frontiermtns,skyfire
cabeast=cabwest,fieldofbone,swampofnohope
cabwest=cabeast,lakeofillomen,warslikswood
charasis=overthere
chardok=burningwood
citymist=emeraldjungle
dalnir=warslikswood
dreadlands=burningwood,firiona,frontiermtns,karnor
droga=frontiermtns,nurga
emeraldjungle=citymist,fieldofbone,trakanon
fieldofbone=cabeast,emeraldjungle,kaesora,kurn,swampofnohope,warslikswood
firiona=dreadlands,lakeofillomen,swampofnohope,timorous
frontiermtns=burningwood,dreadlands,droga,lakeofillomen,nurga,overthere
kaesora=fieldofbone
karnor=dreadlands
kurn=fieldofbone
lakeofillomen=cabwest,firiona,frontiermtns,warslikswood
nurga=droga,frontiermtns
overthere=charasis,frontiermtns,skyfire,timorous,warslikswood
sebilis=trakanon
skyfire=burningwood,overthere,veeshan
swampofnohope=cabeast,fieldofbone,firiona,trakanon
timorous=butcher,firiona,oasis,overthere
trakanon=emeraldjungle,sebilis,swampofnohope
veeshan=airplane,skyfire
warslikswood=cabwest,dalnir,fieldofbone,lakeofillomen,overthere

// 06Velious
cobaltscar=sirens,skyshrine
crystal=eastwastes
eastwastes=crystal,greatdivide,iceclad,kael,sleeper
frozenshadow=iceclad
greatdivide=eastwastes,thurgadina,velketor
growthplane=wakening
iceclad=eastwastes,frozenshadow,nro
kael=eastwastes,wakening
mischiefplane=templeveeshan
necropolis=westwastes
sirens=cobaltscar,westwastes
skyshrine=cobaltscar,wakening
sleeper=eastwastes
templeveeshan=westwastes
thurgadina=greatdivide,thurgadinb
thurgadinb=thurgadina
velketor=greatdivide
wakening=growthplane,kael,skyshrine
westwastes=necropolis,sirens,templeveeshan

// 07Luclin
shadeweaver=sharvahl
sharvahl=shadeweaver
acryliacaverns=grimlingforest
akheva=maidenseye
dawnshroudpeak=griegsend,maidenseye,netherbianlair,sanctusseru
thedeep=echocaverns,ssratemple
echocaverns=thedeep,fungusgrove,shadowhaven
fungusgrove=echocaverns,twilightsea
thegrey=monsletalis,scarletdesert,ssratemple
griegsend=dawnshroudpeak,scarletdesert
grimlingforest=acryliacaverns,hollowshademoor,tenebrousmtns
hollowshademoor=grimlingforest,thepaludalcaverns,sharvahl
maidenseye=akheva,dawnshroudpeak,umbralplains
marusseru=monsletalis,netherbianlair,sanctusseru
monsletalis=thegrey,marusseru
netherbianlair=dawnshroudpeak,marusseru,nexus
thepaludalcaverns=hollowshademoor,sharvahl,shadowhaven
scarletdesert=thegrey,griegsend,twilightsea
ssratemple=thedeep,thegrey
tenebrousmtns=grimlingforest,kattacastellum
twilightsea=fungusgrove,kattacastellum,scarletdesert
umbralplains=maidenseye,vexthal
vexthal=umbralplains
bazaar=nexus,shadowhaven
sanctusseru=tenebrousmtns,twilightsea
shadowhaven=bazaar,echocaverns,nexus,thepaludalcaverns
kattacastellum=tenebrousmtns,twilightsea
nexus=bazaar,netherbianlair,shadowhaven
JAGGEDPINE=

// 08Planes of Power
POKNOWLEDGE=POTRANQUILITY
BOTHUNDER=
NIGHTMAREB=
POFIRE=
POTACTICS=
POAIR=
HOHONORA=
PODISEASE=
POINNOVATION=
POJUSTICE=
PONIGHTMARE=
POSTORMS=
POTIME=
POTORMENT=
POTRANQUILITY=POKNOWLEDGE
POVALOR=
POWATER=
CODECAY=
HOHONORB=
SOLROTOWER=
POEARTH=